{
    "spawn":[1,1],
    "win":[15,4],
    "plate":[
        ["NW","N","N","N","N","N","N","N","N","N","N","N","N","N","N","NE"],
        ["W","g","g","g","g","g","g","g","g","g","g","g","g","g","g","E"],
        ["W","g","g","g","g","g","g","g","g","g","g","g","g","g","g","E"],
        ["W","g","g","g","g","g","g","g","g","g","g","g","g","g","g","E"],
        ["W","g","g","g","g","g","g","g","g","g","g","g","g","g","g","end"],
        ["W","g","g","g","g","g","g","g","g","g","g","g","g","g","g","E"],
        ["W","g","g","g","g","g","g","g","g","g","g","g","g","g","g","E"],
        ["W","g","g","g","g","g","g","g","g","g","g","g","g","g","g","E"],
        ["SW","S","S","S","S","S","S","S","S","S","S","S","S","S","S","SE"]
    ],
    "collision":[
        ["NW","N","N","N","N","N","N","N","N","N","N","N","N","N","N","NE"],
        ["W","g","g","g","w","g","w","w","g","g","g","g","g","g","g","E"],
        ["W","g","w","g","w","g","w","g","g","w","w","w","w","w","g","E"],
        ["W","g","w","g","w","g","g","g","g","g","g","g","g","w","g","E"],
        ["W","g","w","g","g","g","w","w","g","w","w","g","g","w","w","end"],
        ["W","g","w","w","w","w","g","g","g","g","g","g","w","w","g","g"],
        ["W","g","w","g","g","g","g","w","w","g","w","w","w","g","g","g"],
        ["W","g","g","w","w","w","w","g","g","g","g","g","g","g","w","g"],
        ["SW","g","g","g","g","g","g","g","g","g","g","g","g","g","g","g"]
    ]
}